SO                ./texture/space.xpm
      
      
            EA                             ./texture/space.xpm
WE                      ./texture/space.xpm
NO ./texture/space.xpm

            S ./texture/sp_nv.xpm

C                                                                                                                                   35,43,76

      F                                                                        0,0,0

            R 1280 720
        1 1 1 1 1 1 1 1 1 1 1       1 1 1 1 1 1 1 1 1 1 1 1 1 1 1 1 1 1 1 1 1 1 1 1 1 1 1 1 1 1 1 1 1 1 1 1 1 1 1 1 1 1 1 1 1 1 1 1 1 1 1 1 1 1 1
        1 0 0 0 0 0 0 0 0 0 1       1 0 0 0 0 0 0 0 0 0 0 0 0 1
        1 0 1 1 0 2 2 0 0 1 1       1 0 0 0 0 0 0 2 0 0 1 1 1 1
        1 0 0 1 0 0 0 0 0 0 1 1 1 1 1 0 0 0 0 1 1 1 1 1 1
1 1 0 1 1 0 0 0 0 1 1 1 0 0 0 0 0 0 0 0 0 0 0 0 1
1 0 0 0 0 0 0 0 0 0 1 1 0 0 0 0 0 1 1 1 0 1 1 1 1 1 1 1 1
1 1 1 1 0 1 1 1 1 1 1 1 1 0 0 1 1 1 0 0 0 0 0 0 1 0 0 0 1
      1 0 1   1         1 0 1 1 1 1 1 1 1 1 1 1 1 1 0 1 1 1
1 1 1 1 N 1 1 1 1 1 1 1 1 1 0 1 1   1 0 1 0 1 0 0 1 0 0 0 1
1 1 1 1 0 0 0 0 1 1 0 1 0 1 0 1 1   1 0 0 0 0 0 0 0 0 0 0 1
      1 0 0 0 2 0 0 0 0 0 0 0 0 0 0 0 1 1 1 0 0 0 0 0 1 0 1 1 1 1
      1 0 0 0 0 0 0 0 0 0 0 0 0 0 0 0 1 1 0 1 0 1 0 0 1 0 1 1 1
1 1 1 1 0 0 0 1 1 1 0 1 0 1 1 1 1 1 1 1 0 1 1 1 1 0 0 0 1 1 1 1
1 1 1 1 0 1 1 1 1 1 1 0 1 0 1     1 0 1 1 1 1 0 1 0 0 0 1
1 1 1 1 1 1 1 1 1 1 1 1 1 1 1     1 1 1 1 1 1 1 1 1 1 1 1 1